########################################
#......................................#
#.@....................................#
#.....................................#
#....................................#####
#.........DDD...........................E#
#...........................##############
##..................#########
 ##########......####
          ########
